WWWWWWWWWWWWWWWWWWWWWWWWWWWWWWWWWWWWWWWWWWWWWWWWWWWWWW
W0000000000000000000000000000000000000000000000000000W
W0000000000000000000000000000000000000000000000000000W
W00WWWWWWWWW00WW00WWWWWWWWWWWWWWWWWW00WW00WWWWWWWWW00W
W00WWWWWWWWW00WW00WW00000000000000WW00WW0000000000000W
W00WWWWWWWWW00WW00WW00000000000000WW00WW0000000000000W
W00000000000000000WW0000WWWWWW0000WW00WW0000000000000W
W00000000000000000000000WWWW0000000000000000000000000W
W00WWWWWWWWW00WW00000000WWWW0000000000000000000000000W
W00WWWWWWWWW00WW00WWWWWWWWWWWWWWWWWW00W00000000000000W
W000000000WW00WW0000000000000000000000W00000000000000W
W000000000WW00WW0000000000000000000000W00000000000000W
WWWWWWWW00WW00WW00WWWWWWWWWWWWWWWWWW00W000000WWWWWWWWW
000000000000000000W0000000000000000W000000000000000000
000000000000000000W0000000000000000W000000000000000000
WWWWWWWW00WW00WW00W0000000000000000W000000000WWWWWWWWW
W000000000WW00WW00WWWWWWWWWWWWWWWWWW00000000000000000W
W0000000000000000000000000000000000000000000000000000W
W0000000000000000000000000000000000000000000000000000W
W0000000000000000000000000000000000000000000000000000W
W0000000000000000000000000000000000000000000000000000W
W0000000000000000000000000000000000000000000000000000W
W0000000000000000000000000000000000000000000000000000W
W0000000000000000000000000000000000000000000000000000W
W0000000000000000000000000000000000000000000000000000W
W0000000000000000000000000000000000000000000000000000W
W0000000000000000000000000000000000000000000000000000W
W0000000000000000000000000000000000000000000000000000W
WWWWWWWWWWWWWWWWWWWWWWWWWWWWWWWWWWWWWWWWWWWWWWWWWWWWWW
